***0 ***
*      *
***** **
 *  *** 
 **   * 
**  ****
